121111111111111111111111111111111111111111111111111111111111111111111111111111
300000000000000000000000000000000000000000000000000000000000000000000000000001
100123110000100000000010010000100000100000000000000000002000000000000000000001
100000100000000000000100010000000000100000000000000000003000000000000000000001
100000001000100000000000010000100000000000000000000000004000000000000000000001
100010001000001100111101010101110000000000000000000000005000000000000000000001
100600070600607076700000000000000000000000000000030000000000000674300000000001
100000000000000000000000001000000000010000000000000000006000000000000000000001
100001000000100000000100000000001000000000000000000000007000000000000000000001
100020000020202022202200200000002222022020202222200000000000000000000000000001
100000000000100000010000000000100001110000000000000000000000000000000300000001
100001000000100000000100000000001000000000000000000000000000000000000000000001
100010001000001100111101010101110000000000000000000000055000000000089000000001
100001000000100000000100000000001000000000670000000000444000000000000000000001
100001000000100000000100000000001000000000000000000000000300000000000000000001
100010001000001100111101010107770000000000560000000000000000000000000000000001
100010001000001100111101010106660000000000000000000000000000000000000000000001
100020000020202022202200200000002222022020202222200000000000000000000000000001
330003003003021000003000100212300000000210000300000010002000000100200003000001
111111111111111111111111111111111111111111111111111111111111111111111111111111