111111111111111111111111111111111111111111111111111111111111111111111111111111
100000000000000000000000000000000000000000000000000000000000000000000000000001
100111110000100000000010010000100000100000000000000000000000000000000000000001
100000100000000000000100010000000000100000000000000000000000000000000000000001
100000001000100000000000010000100000000000000000000000000000000000000000000001
100010001000001100111101010101110000000000000000000000000000000000000000000001
100000000000000000000000001000000000010000000000000000000000000000000000000001
100001000000100000000100000000001000000000000000000000000000000000000000000001
100000000000100000010000000000100001110000000000000000000000000000000000000001
100001000000100000000100000000001000000000000000000000000000000000000000000001
100010001000001100111101010101110000000000000000000000000000000000000000000001
100001000000100000000100000000001000000000000000000000000000000000000000000001
100001000000100000000100000000001000000000000000000000000000000000000000000001
100010001000001100111101010101110000000000000000000000000000000000000000000001
100010001000001100111101010101110000000000000000000000000000000000000000000001
111111111111111111111111111111111111111111111111111111111111111111111111111111